{
  "field": [
    "###############",
    "#.............#",
    "#.............#",
    "#.............#",
    "#.............#",
    "#.............#",
    "#.............#",
    "#......S......#",
    "#.............#",
    "#.............#",
    "#.............#",
    "#.............#",
    "#.............#",
    "#.............#",
    "###############"
  ],

  "initial_snake_length": 3,
  "max_step_limit": 500,

  "rewards": {
    "timestep": 0,
    "good_fruit": 1,
    "bad_fruit": -1,
    "died": -1,
    "lava": -5
  }
}
