{
  "field": [
    "################",
    "#....O#!.......#",
    "#.....#........#",
    "#..########....#",
    "#.......#...#..#",
    "#.......#...#..#",
    "###..#####..####",
    "#..#...........#",
    "#..#.......#...#",
    "#....####..#...#",
    "#.......#..#...#",
    "#.......#..#...#",
    "####..#######..#",
    "#......#S......#",
    "#o.....#.......#",
    "################"
  ],

  "initial_snake_length": 2,
  "max_step_limit": 100,

  "rewards": {
    "timestep": 0,
    "good_fruit": 6,
    "bad_fruit": -1,
    "died": -1,
    "lava": -5
  }
}
